#MAP GRID
g g g g g g g g g g g g g g g g g g g g g g g g g g g g g g
g g g g g g g g g g g d d d d d d d d d d d d d d d d d d d
g g g g g g g g g g g d d d d d d d d d d d d d d d d d d d
g g g g g g g g g g g d d g g g g g g g g g g g g g g d d g
g g g g g g g g g g g d d g g g g g g g g g g g g g g d d g
g g g g g g g g g g g d d g g g g g g g g g g g g g g d d g
g g g g g g g g g g g d d 0 0 0 0 d d d d d d d d d d d d g
g g g g g g g g g g g d d 0 0 0 0 d d d d d d d d d d d d g
g g g g g g g g g g g d d 0 0 0 0 d d g g g g g g g g g g g
g g g g g g g g g g g d d 0 0 0 0 d d g g g g g g g g g g g
g g g g g g g g g g g d d 0 0 0 0 d d g g g g g g g g g g g
d d d d d d d d d d d d d 0 0 0 0 d d g g g g g g g g g g g
d d d d d d d d d d d d d 0 0 0 0 d d g g g g g g g g g g g
g g g g g g g g g g g g g 0 0 0 0 d d g g g g g g g g g g g
g g g g g g g g g g g g g 0 0 0 0 d d g g g g g g g g g g g
g g g g g g g g g g g g g 0 0 0 0 d d g g g g g g g g g g g
g g g g g g g g g g g g g 0 0 0 0 d d g g g g g g g g g g g
#TURRETS type y x
8
0 14 11
0 14 20
0 4 14
0 5 22
0 10 10
1 2 10
1 9 20
0 9 27
#ENEMY SPAWN POSITIONS x y
0 362
561 512
#TURRET TYPES
3
0
1
2