#MAP GRID
g g g g g g g g g g g g g g g g g g g g g g g g g g g g g g
g g g g g g g g g g g d d d d d d d d d d d d d d d d d d d
g g g g g g g g g g g d d d d d d d d d d d d d d d d d d d
g g g g g g g g g g g d d 0 0 0 0 g g g g g g g g g g d d g
g g g g g g g g g g g d d 0 0 0 0 g g g g g g g g g g d d g
g g g g g g g g g g g d d 0 0 0 0 g g g g g g g g g g d d g
g g g g g g g g g g g d d 0 0 0 0 d d d d d d d d d d d d g
g g g g g g g g g g g d d 0 0 0 0 d d d d d d d d d d d d g
g g g g g g g g g g g d d 0 0 0 0 d d g g g g g g g g g g g
g g g g g g g g g g g d d 0 0 0 0 d d g g g g g g g g g g g
g g g g g g g g g g g d d 0 0 0 0 d d g g g g g g g g g g g
d d d d d d d d d d d d d 0 0 0 0 d d g g g g g g g g g g g
d d d d d d d d d d d d d 0 0 0 0 d d g g g g g g g g g g g
g g g g g g g g g g g g g 0 0 0 0 d d g g g g g g g g g g g
g g g g g g g g g g g g g 0 0 0 0 d d g g g g g g g g g g g
g g g g g g g g g g g g g 0 0 0 0 d d g g g g g g g g g g g
g g g g g g g g g g g g g 0 0 0 0 d d g g g g g g g g g g g
#TURRETS type x y
4
0 2 10
0 10 10
0 10 20
0 9 27

